8 8
3 1
1 1 1 1 1 1 1 1
1 1 0 0 0 1 1 1
1 1 0 1 2 0 0 1
1 0 4 3 0 3 0 1
1 0 0 2 2 0 1 1
1 1 1 0 1 3 1 1
1 1 1 0 0 0 1 1
1 1 1 1 1 1 1 1