9 7
3 3
1 1 1 1 1 1 1 1 1
1 1 1 1 1 0 0 1 1
1 0 0 0 3 3 2 1 1
1 0 2 0 1 0 2 0 1
1 1 2 3 3 0 0 0 1
1 1 0 0 1 1 0 0 1
1 1 1 1 1 1 1 1 1